//MAP CONVERTED BY dmm2tgm.py THIS HEADER COMMENT PREVENTS RECONVERSION, DO NOT REMOVE
"a" = (
/obj/machinery/deepfryer,
/obj/effect/turf_decal/tile/brown/opposingcorners{
	dir = 1
	},
/obj/effect/turf_decal/tile/yellow/opposingcorners,
/obj/machinery/light{
	dir = 1
	},
/turf/open/floor/plasteel/cafeteria,
/area/template_noop)
"b" = (
/obj/effect/turf_decal/siding/yellow{
	dir = 1
	},
/turf/open/floor/plasteel/textured,
/area/template_noop)
"c" = (
/obj/item/storage/bag/trash,
/obj/effect/decal/remains/human,
/mob/living/simple_animal/mouse,
/obj/machinery/light/small{
	dir = 4
	},
/turf/open/floor/plating/damturf/platdmg1,
/area/template_noop)
"d" = (
/obj/effect/turf_decal/siding/yellow{
	dir = 8
	},
/obj/machinery/light{
	dir = 8
	},
/turf/open/floor/plasteel/textured,
/area/template_noop)
"e" = (
/obj/effect/turf_decal/tile/dark/half/contrasted{
	dir = 1
	},
/turf/open/floor/plasteel/damturf/damage3,
/area/template_noop)
"g" = (
/turf/open/floor/plating/damturf/platdmg1,
/area/template_noop)
"h" = (
/obj/effect/turf_decal/tile/brown/opposingcorners{
	dir = 1
	},
/obj/effect/turf_decal/tile/yellow/opposingcorners,
/obj/structure/table/wood/fancy,
/turf/open/floor/plasteel/cafeteria,
/area/template_noop)
"i" = (
/obj/machinery/vending/dinnerware{
	contraband = list(/obj/item/kitchen/rollingpin=2,/obj/item/kitchen/knife/butcher=2,/obj/item/reagent_containers/food/condiment/flour=4)
	},
/obj/effect/turf_decal/tile/brown/opposingcorners{
	dir = 1
	},
/obj/effect/turf_decal/tile/yellow/opposingcorners,
/turf/open/floor/plasteel/cafeteria,
/area/template_noop)
"j" = (
/obj/effect/turf_decal/siding/yellow{
	dir = 8
	},
/turf/open/floor/plasteel/textured,
/area/template_noop)
"k" = (
/mob/living/simple_animal/pet/fox,
/obj/effect/turf_decal/tile/brown/opposingcorners{
	dir = 1
	},
/obj/effect/turf_decal/tile/yellow/opposingcorners,
/turf/open/floor/plasteel/cafeteria,
/area/template_noop)
"l" = (
/obj/effect/turf_decal/tile/dark/half/contrasted{
	dir = 8
	},
/turf/open/floor/plasteel/damturf/scorched1,
/area/template_noop)
"m" = (
/obj/effect/turf_decal/siding/yellow{
	dir = 5
	},
/turf/open/floor/plasteel/textured,
/area/template_noop)
"n" = (
/obj/effect/turf_decal/tile/dark/half/contrasted,
/turf/open/floor/plasteel/textured,
/area/template_noop)
"o" = (
/obj/effect/turf_decal/tile/dark/anticorner/contrasted{
	dir = 4
	},
/turf/open/floor/plasteel/textured,
/area/template_noop)
"p" = (
/obj/item/trash/sosjerky,
/mob/living/simple_animal/mouse,
/turf/open/floor/plating,
/area/template_noop)
"q" = (
/obj/structure/sign/flag/vulp{
	pixel_x = 0;
	pixel_y = 32
	},
/obj/effect/turf_decal/tile/brown/opposingcorners{
	dir = 1
	},
/obj/effect/turf_decal/tile/yellow/opposingcorners,
/obj/structure/table/wood/fancy,
/turf/open/floor/plasteel/cafeteria,
/area/template_noop)
"r" = (
/obj/machinery/light/small,
/obj/structure/table,
/obj/effect/turf_decal/tile/dark/half/contrasted,
/turf/open/floor/plasteel/textured,
/area/template_noop)
"s" = (
/obj/effect/turf_decal/siding/yellow{
	dir = 1
	},
/obj/structure/sign/poster/official/mac_vulpix{
	pixel_x = 0;
	pixel_y = 32
	},
/turf/open/floor/plasteel/textured,
/area/template_noop)
"t" = (
/obj/structure/chair{
	dir = 8
	},
/obj/effect/turf_decal/tile/dark/half/contrasted,
/turf/open/floor/plasteel/textured,
/area/template_noop)
"u" = (
/obj/item/trash/popcorn,
/turf/open/floor/plating,
/area/template_noop)
"v" = (
/obj/structure/chair/stool/bar{
	dir = 8
	},
/obj/effect/turf_decal/siding/yellow{
	dir = 8
	},
/turf/open/floor/plasteel/textured,
/area/template_noop)
"w" = (
/obj/effect/turf_decal/tile/dark/half/contrasted{
	dir = 8
	},
/turf/open/floor/plasteel/textured,
/area/template_noop)
"x" = (
/obj/effect/turf_decal/tile/brown/opposingcorners{
	dir = 1
	},
/obj/effect/turf_decal/tile/yellow/opposingcorners,
/obj/machinery/vending/snack/max_vulpix,
/turf/open/floor/plasteel/cafeteria,
/area/template_noop)
"y" = (
/turf/open/floor/plating/damturf/platdmg3,
/area/template_noop)
"z" = (
/obj/effect/turf_decal/siding/yellow/corner{
	dir = 8
	},
/obj/effect/turf_decal/tile/dark/half/contrasted{
	dir = 1
	},
/turf/open/floor/plasteel/textured,
/area/template_noop)
"B" = (
/obj/effect/turf_decal/tile/brown/opposingcorners{
	dir = 1
	},
/obj/effect/turf_decal/tile/yellow/opposingcorners,
/obj/machinery/light{
	dir = 8
	},
/turf/open/floor/plasteel/cafeteria,
/area/template_noop)
"C" = (
/turf/open/floor/plating,
/area/template_noop)
"D" = (
/turf/open/floor/plasteel/textured,
/area/template_noop)
"E" = (
/obj/effect/turf_decal/tile/dark/anticorner/contrasted,
/turf/open/floor/plasteel/textured,
/area/template_noop)
"H" = (
/obj/effect/turf_decal/tile/brown/opposingcorners{
	dir = 1
	},
/obj/effect/turf_decal/tile/yellow/opposingcorners,
/obj/machinery/microwave{
	pixel_x = -3;
	pixel_y = 6
	},
/obj/structure/table/wood/fancy,
/turf/open/floor/plasteel/cafeteria,
/area/template_noop)
"I" = (
/obj/item/trash/tray,
/turf/open/floor/plating/damturf/platdmg3,
/area/template_noop)
"J" = (
/obj/item/kirbyplants/random,
/obj/effect/turf_decal/siding/yellow{
	dir = 1
	},
/turf/open/floor/plasteel/textured,
/area/template_noop)
"K" = (
/obj/machinery/door/airlock/maintenance{
	req_access_txt = "12"
	},
/obj/effect/turf_decal/tile/brown/opposingcorners{
	dir = 1
	},
/obj/effect/turf_decal/tile/yellow/opposingcorners,
/turf/open/floor/plasteel/cafeteria,
/area/template_noop)
"L" = (
/obj/effect/turf_decal/siding/yellow/corner{
	dir = 4
	},
/obj/effect/turf_decal/tile/dark/half/contrasted{
	dir = 8
	},
/turf/open/floor/plasteel/textured,
/area/template_noop)
"N" = (
/turf/closed/wall,
/area/template_noop)
"P" = (
/obj/effect/turf_decal/siding/yellow,
/obj/effect/turf_decal/tile/dark/half/contrasted{
	dir = 1
	},
/turf/open/floor/plasteel/textured,
/area/template_noop)
"Q" = (
/obj/effect/turf_decal/tile/dark/half/contrasted{
	dir = 1
	},
/turf/open/floor/plasteel/damturf/scorched2,
/area/template_noop)
"R" = (
/obj/effect/turf_decal/tile/brown/opposingcorners{
	dir = 1
	},
/obj/effect/turf_decal/tile/yellow/opposingcorners,
/turf/open/floor/plasteel/cafeteria,
/area/template_noop)
"S" = (
/obj/effect/turf_decal/tile/dark/half/contrasted{
	dir = 4
	},
/turf/open/floor/plasteel/textured,
/area/template_noop)
"T" = (
/obj/machinery/reagentgrinder{
	pixel_y = 8
	},
/obj/effect/turf_decal/tile/brown/opposingcorners{
	dir = 1
	},
/obj/effect/turf_decal/tile/yellow/opposingcorners,
/obj/structure/table/wood/fancy,
/turf/open/floor/plasteel/cafeteria,
/area/template_noop)
"U" = (
/obj/effect/turf_decal/siding/yellow{
	dir = 8
	},
/obj/structure/sign/poster/official/mac_vulpix{
	pixel_x = -32;
	pixel_y = 0
	},
/turf/open/floor/plasteel/textured,
/area/template_noop)
"V" = (
/obj/effect/turf_decal/siding/yellow/corner{
	dir = 1
	},
/turf/open/floor/plasteel/textured,
/area/template_noop)
"W" = (
/obj/structure/chair/stool/bar{
	dir = 1
	},
/obj/effect/turf_decal/siding/yellow{
	dir = 1
	},
/turf/open/floor/plasteel/textured,
/area/template_noop)
"X" = (
/obj/structure/chair{
	dir = 4
	},
/obj/effect/turf_decal/tile/dark/anticorner/contrasted{
	dir = 8
	},
/turf/open/floor/plasteel/textured,
/area/template_noop)
"Y" = (
/obj/effect/turf_decal/siding/yellow/corner{
	dir = 4
	},
/turf/open/floor/plasteel/textured,
/area/template_noop)
"Z" = (
/obj/machinery/vending/cola/random,
/turf/open/floor/plasteel/textured,
/area/template_noop)

(1,1,1) = {"
g
y
u
I
y
l
l
L
w
X
"}
(2,1,1) = {"
g
p
c
N
N
N
N
J
D
r
"}
(3,1,1) = {"
C
N
N
N
x
R
K
m
Y
t
"}
(4,1,1) = {"
e
N
H
i
R
R
N
N
s
n
"}
(5,1,1) = {"
Q
N
q
R
R
R
B
h
W
n
"}
(6,1,1) = {"
P
N
a
R
R
k
R
h
W
n
"}
(7,1,1) = {"
P
N
N
T
R
R
R
h
W
n
"}
(8,1,1) = {"
P
Z
N
N
h
h
h
N
b
n
"}
(9,1,1) = {"
z
j
U
d
v
v
v
d
V
n
"}
(10,1,1) = {"
o
S
S
S
S
S
S
S
S
E
"}
